1111111111111
1000000000001
1000011111001
1001000009001
100C011111001
1001000009001
1000011011001
10P01100E0001
1111111111111